Employee ID,Employee Name,Total Hours Worked,Gross Pay,Tax,Net Pay
1,John Doe,160,80000,8000,72000
2,Jane Smith,140,70000,7000,63000
3,Michael Johnson,180,90000,9000,81000
4,Sarah Williams,160,80000,8000,72000
5,Robert Brown,150,75000,7500,67500
6,David Wilson,170,85000,8500,76500
7,Emily Davis,145,72500,7250,65250
8,Joshua Taylor,180,90000,9000,81000
9,Samantha Martinez,155,77500,7750,69750
10,Christopher Anderson,165,82500,8250,74250